********************************
********************************
**............................**
**............................**
**............................**
**............................**
**............................**
**............................**
**............................**
**............................**
**............................**
**............................**
**............................**
**............................**
**............................**
**............................**
**............................**
**............................**
**............................**
**............................**
**............................**
**............................**
**................*...........**
**...............@.*..........**
**...............**...........**
**............................**
**............................**
**............................**
********************************
********************************
